NDF = "countries/Nordway.txt"
REX = "countries/Rexage.txt"
BRF = "countries/Boreas.txt"
GSR = "countries/GSR.txt"
DUT = "countries/Duty.txt"
LOM = "countries/Lomonosia.txt"
VCC = "countries/VCC.txt"
CMB = "countries/Combine.txt"
RES = "countries/Resistance.txt"
RUS = "countries/Russia.txt"
DMD = "countries/DD.txt"
XOF = "countries/XOF.txt"
CFA = "countries/CFA.txt"
ROG = "countries/RogueC.txt"
ZRS = "countries/ZeroRisk.txt"
MBE = "countries/Mbele.txt"
MUJ = "countries/Mujahideen.txt"
BLK = "countries/Blackwater.txt"
SNI = "countries/Sandline.txt"
UKR = "countries/Ukraine.txt"
UUD = "countries/UUD.txt"
AZT = "countries/Aztecas.txt"
VAG = "countries/Vagos.txt"
SRB = "countries/SerbMafia.txt"
SBR = "countries/SerbPatriots.txt"
TRK = "countries/TurkMafia.txt"
MBA = "countries/Mabinio.txt"
SCA = "countries/Scalette.txt"
NGD = "countries/Nouveau.txt"
APA = "countries/Apache.txt"
KLA = "countries/Klan.txt"
NSP = "countries/Newspain.txt"
UUN = "countries/UN.txt"
FON = "countries/Foundation11.txt"
MJX = "countries/Majestic23.txt"
NDC = "countries/AntiNDF.txt"
ZRC = "countries/Zethes.txt"